c7777777777777777777777777779
b6666666666666666666666666668
b1111111111111111111111111118
b1111111111111111111111111118
b1111111111111111111111111118
b1111111111111111111111111118
b1111111111111111111111111118
b1111111111111111111111111118
b1111111111111111111111111118
b1111111111111111111111111118
b1111111111111111111111111118
b1111111111111111111111111118
b1111111111111111111111111118
daaaaaaaaaaaaaaaaaaaaaaaaaaae
