/ b68 0 1 2
/ a57 3
/ c9d 4
/
b66666666666666666668     b66668
a55555555555555555557     a55557
a00000000000000000007     a00007
a00000000000000000007     a00007
a00000000000000000007     a00007
a0000000009999990000666666600007
a0000000007    a0000000000000007
a0000000007    a0000000000000007
a0000000007    a0000000000000007
a0000000007    a0000000000000007
c999999999d    c999999999999999d
