/ b68 0 1 2
/ a57 3
/ c9d 4
/
b6666666666666666666666666668
a5555555555555555555555555557
a0000000000000000000000000007
a0000033333300000000000000007
a0000044444400000000000000007
a0000044444433333000000000007
a0000044444444444000000000007
a0000000000000044000000000007
a0000000000000044000000000007
a0000000000000000000000000007
a0000000000000000000000000007
a0000000000000000000000000007
a0000000000000000000000000007
c999999999999999999999999999d
